29,24
19,15,2,2,24,20,13,18,19,11,1,21,4,9
11
2,17,2,22,10,22,10,17
14,14,14,21,19,14
20,15,20,20,23,17,23,15
25,14,25,17,26,17,26,14
1,10,1,14,3,14,3,10
5,10,6,15,8,15,10,10
13,8,12,12,15,12,19,8
20,7,20,12,27,12,27,7
1,4,1,8,11,8,11,4
12,2,14,6,17,6,17,3
20,1,20,5,22,5,26,1