29,24
25,4,2,9
13
5,17,5,21,7,21,7,17
10,15,10,19,12,19,12,15
14,14,14,21,19,14
20,15,20,20,23,17,23,15
25,14,25,17,26,17,26,14
1,10,1,14,3,14,3,10
5,10,6,15,8,15,10,10
12,8,12,12,15,12,15,8
20,7,20,12,27,12,27,7
16,9,16,13,18,13,18,9
1,4,1,8,11,8,11,4
12,1,14,6,17,6,17,1
20,1,20,5,22,5,26,1